R 1080 720
SO ./textures/sky_1.xpm
NO ./textures/sky_1.xpm
WE ./textures/sky_1.xpm
EA ./textures/sky_1.xpm

S ./textures/sprite.xpm
C 0,2,47
F 67,154,178

111111111111111111111111111111111
100000000000000000000000000000001
110101010101010101010101010101011
100000000000000000000000000000001
101010101010101010101010101010101
100000000000000000000000000000001
110101010101010101010101010101011
100000000000000000000000000000001
101010101010101010101010101010101
100000000000000000000000000000001
110101010101010101010101010101011
100000000000000000000000000000001
101010101010101010101010101010101
100000000000000000000000000000001
110101010101010101010101010101011
100000000000000000000000000000001
101010101010101010101010101010101
100000000000000000000000000000001
110101010101010101010101010101011
100000000000000N00000000000000001
101010101010101010101010101010101
100000000000000000000000000000001
110101010101010101010101010101011
100000000000000000000000000000001
101010101010101010101010101010101
100000000000000000000000000000001
110101010101010101010101010101011
100000000000000000000000000000001
101010101010101010101010101010101
100000000000000000000000000000001
110101010101010101010101010101011
100000000000000000000000000000001
111111111111111111111111111111111