R 300 300
NO ./textures/sky_1.xpm
SO ./path_to_the_south_texture
WE ./textures/sky_2.xpm
EA ./path_to_the_east_texture

S ./path_to_the_sprite_texture
C 255,0,0
F 0,255,0

111111111111111111111111111111111
100000000000000000000000000000001
110101010101010101010101010101011
100000000000000000000000000000001
101010101010101010101010101010101
100000000000000000000000000000001
110101010101010101010101010101011
100000000000000000000000000000001
101010101010101010101010101010101
100000000000000000000000000000001
110101010101010101010101010101011
100000000000000000000000000000001
101010101010101010101010101010101
100000000000000000000000000000001
110101010101010101010101010101011
100000000000000000000000000000001
101010101010101010101010101010101
100000000000000000000000000000001
110101010101010101010101010101011
100000000000000E00000000000000001
101010101010101010101010101010101
100000000000000000000000000000001
110101010101010101010101010101011
100000000000000000000000000000001
101010101010101010101010101010101
100000000000000000000000000000001
110101010101010101010101010101011
100000000000000000000000000000001
101010101010101010101010101010101
100000000000000000000000000000001
110101010101010101010101010101011
100000000000000000000000000000001
111111111111111111111111111111111