R 1080 740
NO ./textures/sky_1.xpm
SO ./textures/metal.xpm
WE ./textures/wood.xpm
EA ./textures/stone.xpm

S ./path_to_the_sprite_texture
F 0,100,0
C 255,30,167
11111111111111111111111111111111111111111111111111
10100000010012100100001000010000000020100000202021
12000001100000000000100000001020000200001010010201
10010000100010000001000000012100011100002100120001
11000001001110010000100000000000000001010000000001
11000020101020100110000210100000000011000000010001
10100000200110010000000200100000001001010110102001
10000001000100001010100001000000010000200100110001
11101001000000000010100110000001001000000010110101
11000010010010000211120100000010010002100001000001
10000021000111000000001111000000000000000001000021
11001121000002100000000100000010000000000000000001
10000010000000002100000000011100100100000221000001
11001100000000010000200000000101000001010110000101
10100010000010011100101100100100000110101000010001
10100200000000010000000101100110010000100120010001
10000100011000011010020020010100020001000010002001
10010201000000011200000000002000000101000010110111
10000210101101000100110001000100101000010002100001
12011100000100120000020000010111000001110000000001
10000000020010002000010000002000000200001011000011
10001010000200010010100000000001100000001100010011
10000000001010000000000100000020111010021010000001
10001120000010000000000000001110000200101001100011
10000100100010011000001000011001100110000010101101
1000010101000110010000010E120000001000011000000111
10010000020002000000201010100200000000210000112011
10020000000020000000000100000001100100101000000021
12020011000001002001000001000010000010000010000001
10111000000100010001010000000001000100001101100021
11000020001110001000000200010000000000000100000101
10010000000000000000000000001000210010100000000001
11000010000100100110100100000000010000011001000111
10000000000000000000000000000001000100001110000101
10000011000100000000010010000000000010000010001011
10000001100000000000000000000000000001200000000001
10001000011000000000001000000001000010000000000011
10100100020010110010000000201000000000001000010001
10000000001001001001000101000001000010000000000001
10011001002002110010000111000000100011010000100201
10200000020001010000100010110010000000000001100001
10001010000010010000100000000110001012000010100001
10000001010000001010000000110000010001000010110101
12100001000000000000020000111101011000000111000001
10020000010000110110000000000001112000001000000001
11100000000010000001000100001101000001100000010001
10002101011002000201000000220000000001100010000111
10000001000000000000121000010002000011001000000101
12100000010000000100000011110000000100010000000121
11111111111111111111111111111111111111111111111111
