R 1080 720
NO ./textures/sky_1.xpm
SO ./textures/metal.xpm
WE ./textures/wood.xpm
EA ./textures/stone.xpm

S ./textures/sprite.xpm
F 0,100,0
C 255,30,167
111111111111111
100000000001001
100101000100121
100010001001001
100000100010101
100010200002011
110000000010001
1001000N0000001
100020010001101
100021010010101
110100001100001
110110100000001
100002011100001
120010100001001
111111111111111
