R 1080 740
NO ./textures/sky_1.xpm
SO ./textures/metal.xpm
WE ./textures/wood.xpm
EA ./textures/stone.xpm

S ./path_to_the_sprite_texture
F 0,100,0
C 255,30,167
1111111111111111111111111111111111111111111111111111111111111111111111111111111111111111111111111111
1020010000101010001010002100000000000100000100120000000000100000010200001002100000000000010001000021
1100000000000111000000100100000011000110020000000001000000021000000000001000000100001000000000001001
1010000000001101001000011001001121100000010000000000010002000211100100000000000000000010010000110001
1100010000000100000000110001100000021100101000000100122000000000011020001002110000210000000000000201
1111001100000100200010000010000000010000000010000100100201000000000001100010010000000000101000110021
1000011000010001100110002010000001010002000010001110000001101000000000010110000000000010100002000101
1001000100110000011100120000100001100010000020001000000000110000011110011100020111200121010010000001
1010011000101100000010001011002000020000001000000101101100100000010220000000000100000000100000010201
1111010000120002000100000201002000010110000001001100001020100001010000001001100001000100110021010001
1101100000000000001100000010000000000000000110100000110010000000000001001000010010010010000000001001
1110001020010100000100000000201000001000000100002000000000000100200000000000010010000011100010002011
1000000100100020110000000121001000001100010010000021100100000000001000000200000000000101020000000001
1000001000002000000010020000000001000210000001010000201120001001000000000000000011110000010020011011
1000200000000010000010001000011000010100000010000001000000000000121000000100000000100010000100000001
1100000021001001110121200010100011000010000010000000010100000001110010000000000000000011000110000001
1100010000110012101100110100010000201000102020010000020100000011001000110100001010002011011000000101
1100100100000101000110011000100000001000210100000001001000000000100100210100010000000100000000110011
1100010001110000010101010000100110001000001100201000001101100110002000020000002001000000000002000101
1010000000110010111101011020000010100110001000110001110200000000000100000000002010000010000001010001
1000000100000101000000000010000000001200000100101010002010100010000000000100010000000000100201100011
1200010010100110000001100000001010010000000110101100001001000100000000100000000010001000000000020001
1101000201001000000111000000000000021000000000200010000100211000011000010100210000000100001201020111
1001000000100000200000000010020010000000000000001000000112202110111000001110011000010000100000010101
1000002100102001111001000000000011200000112110200010000000000000000110010100000100012101000100010001
1000100000000000002001000210000001100100001011000000000000001010000000000100001000100000100110001201
1000000101001000201000100002000001001000000021000012000000000100001010000010110002000000000101001101
1120100010000000010010000101000000000100010100000010011001000100200011000000011000100001010010000011
1000000021010001111010000000000010000000000000020100100000000200000000000100020000100010001111000001
1000000000000000000000000000000000101000000000101001000000000011000020000020212000100100000011000001
1001000000001011000000100010001000010000000000000001000000000000001000000001200100010000001011000001
1100011000100110220000120210000100001100100000000021001100100110001010200001001000011001000000000001
1000000110000000001100000000000210000100011200002101000101000000110010001011001110010010101020001001
1000000002001210100000100110001000000011101100100000000001011012000001000000000000100100001000211001
1200011210012000000111111000100100000010000001020000000010100011101000000000100020000200101000000101
1001101000000001000001000100001000010010002001000011210000100000020010101100000000100201002000010001
1000000000000010000000100100000101000011000002200000100000000001001010000001010000000110001000100001
1100202000002001100000100000201000000210010000001000010100200101000100110000100102000000000010000101
1010001201020012110000110110010100010001000000001020000000010000001010000010100100010000002000100101
1000000001000001110000100000000000010001000111001000000000000100001000000000000000001001000102200011
1001010000000000000000000010000100100101000000100100011101102000000101000100000110020012000001101001
1001000010100000011000000100001000000100000000111000001020000000101000002100000100001110100000100001
1010110100100000001100010000100000110000000110001002111010000011100012010010000000100100000011000001
1010000021000110000001000101100000001100000000011100001100000001021100000000000101021000010000001001
1000001000100000200001000010010100010001000010001000000200000000001001001100000000001000111000100011
1000000010000100100002010000002011000000011100010010001200101011000000010000000010001000001010000001
1000021000020010100000010100100001200001111000000100100000000000010000020000000010010000000011200001
1000000002101000002000010000120000100100000101000000010000011010000000001000011020000000000010000011
1000000000000020001001002110210010000000111100000000100100000100001010010201002000100011010000100011
1000000120000001000101100100000000000000010001011000000010011000000110000200000010021000000102002001
10000100000100001000000000111001010110100001000000N0000100000011000100110010010100110000011000110001
1000010100100010100020000010100000001001000100000011000000001000010000001000002100001000000000000011
1000100000001000000010000001200000002000000211200000000000010000000000021000000000100020000000000101
1010010111000001001000010000100100000000010000011011200001200200001000010011000000010000001000010001
1001000000001000010001000001000100000010000020000100000010101021000000000100200000000101001001021101
1001010000101000000010000102020000010112100010000000010000000000001000110010100000000000000010100011
1010100000100000000000000000200002000102102210110010000100010010000020000010200000021000000002000121
1000010010010111010002000000001000100000100000000110000010010201000001002000000010002002100001000001
1010000110010110000000011001000011000000000200100001000010001001000000000001021000000000000111000001
1001000100210000000000000000010010002000012000111000100001000010100110000010100000001012000000000101
1000000002001000011021010100110000000001020001211000000200010121000101001000000020100011110000001201
1000000011001000000000001000000010001000010101000010010000101000100000001001001011001011000020100001
1101010020112001000000020001000000102012001000100000110101111011010010100000001000020010000000001001
1000000100100010100020000000101010001001000001200000000000000100010000000000000000010001000000100001
1000000000100010110111100000000020000010010001000111010100100010000010100010010000000010000010100001
1100010001000000101000011001100010020010100011010000000000000000110002020101010001000100211100000001
1001001001020001000000000100000010001000010000001000010000110000001021020101201011000000000010000201
1000000020120100000100000011110000101201000010201012020001001001000012000000011100001001000100000001
1000000210010000001000000000000011200000001000000000100021101000000001200000000011010001000011000101
1211000001001011100100001000000000001000000100100002000000201000000010000012100100200101000000000001
1010000000000110000000000010110000000000000120010001001000000201000001101110100010200110000000000101
1000010011000000201001100100100100001010010010000001000200000000000000000000100020000000000000001021
1000001001000000000100100000000010000010100020000000001000001000000001000010010010000000000002000101
1011201000010100001000110020110100000001010000011001101100001120100011000200000021110101000200000201
1200000101010000010000000020020102000100002001000000010101100000000000100000010001100001100000000001
1000011000000010002110000000010010000000000000001012010000010002000110000000100000000000012100010001
1000000000010001000000100000000001000000000000000001000100100000000000000002200121000000102000000001
1100000000010000200001000001002010010120000000010110001000010200000000100120000000011000001100100011
1000011001000000000001101010100010000002020000000010000121010000020000001000000001010002011010000001
1010000010000000001001002001000000000000112000010001000100000002010000001000101000000001101010000001
1000010100200110100010100200100000100020000000002000000000100000000001000000000000000111000000000001
1000001000000000100000010010001000000010000000000000000100000000000010102100010010122010100111000021
1000010000000000100000000000000000000000110020000010000000000100010000000001000000000100011000000011
1110000000010010000000010000020100010000021111000120100101001010100010000000111100000200000000000101
1000210000001000000000000010000000010011011000000000000010000010000000010002020110011111000000111111
1000100101010011001001100000010020101001011010000000011010100000000002000100011000000000010000000001
1011001010200101010020000000210001000010001000020000000010000000000001001000002001001011011020000001
1200000100001110000000000001000010000000110001100000101001000001100120000000000002110100000001011001
1000001010100000000101001021201000001000100110100010000000100000101101000101010002200100000210000001
1000001010000100011000100210000010000000000000001001000001001001200000110100002000000001100001100011
1000100000011001010011100010000000000000000100000100000110010220010000110001100110010000100100001111
1121001100111000100010000100000020000000010101100011010000000002000001000000020020001010011000000001
1000000000010000000000010001010000102221010101100101000100010010000000000020000000210110001000000001
1000100000000001010000010011000100000011120000101000010000000000010001000001010011000001100011002001
1000000000002011110010000001000000000000000011110010100101000000000000000020000000001000000000001001
1000000000000001000101100000000101000101000100001000112100000000010210001010000010200200101000000001
1000010010201010000000000020000110020200000000000010010000111000100111001101000010000000000012000101
1100000020010002020100001000102100100000000012101010000001011210010000000100100100000010000000010001
1111100000210001000000000011000100001001000021010000010000000001010010001002000101010100000001000001
1111111111111111111111111111111111111111111111111111111111111111111111111111111111111111111111111111
