R 1080 720
NO ./textures/sky_1.xpm
SO ./textures/metal.xpm
WE ./textures/wood.xpm
EA ./textures/stone.xpm

S ./path_to_the_sprite_texture
F 0,0,0
C 0,0,0

       11111111111111111111111111
       10000000000110000000000001
       11011000001110000002000001
       11001000000000000000000001
111111110110000011100000000000001
100000000000000001111101111111111
11110111111111011100000010001
11110111111111111101010010001 
11000000110101011100000000001
10002000000000000100000010001
10000000000000001101010000001
1100000111010101110101101000111
11110111 1110101 101111010001
11111111 1110111 111111311111
    11111111111111000000000011111111111
    10000000000000000000000000000000001
    10001111111111000200000000000000001
    10001000000001111110000000000001111
    100010020000000000111111111111311
    1000100N00020000000001      10001
    100010000200000020000111111110201
    100000000000000000000000000000001
    111111111111111111111111111111111