R 1024 720
SO ./textures/sky_1.xpm
NO ./textures/sky_1.xpm
WE ./textures/sky_1.xpm
EA ./textures/sky_1.xpm

S ./path_to_the_sprite_texture
C 0,2,47
F 67,154,178

     11111                11111
   110000011            110030011
  10000000001          10000000001
 1000000000001111111111000000000001
 100000N000000000000000000002000001
 1000000000001111331111030000000001
  10000000001   1001   10000000001
   110000011    1001    100000001
     10001      1001     1100011
      101       1001       101
      101       1001       101
      101       1001       101
      101111111110011111111101
      100000000000000000000001
      101111111110011111111101
      101       1001       101
      101       1001       101
     10001      1001      10001
   110000011    1001    110000011
  10000000001   1001   10000000001
 1000000000001111001111000000000001
 1000000000000001001000000000000001
 1000000000001111001111000000000001
  10000000001   1001   10000000001
   110000011    1001    110000011
     11111      1001      11111
                1331
                1331
          1111111001111111
          1000000000000001
          1000000000000001
          1000000000000001
          1000000000000001
          1000000000000001
          1000000000000001
          1000000000000001
          1000000000000001
          1000000000000001
          1111111111111111