R 1080 720
SO ./textures/sky_1.xpm
NO ./textures/sky_1.xpm
WE ./textures/sky_1.xpm
EA ./textures/sky_1.xpm

S ./textures/sprite.xpm
C 0,2,47
F 67,154,178

     11111                11111
   110020011            112000211
  10000200001          12000000021
 1000002000001111111111220220220221
 100000N000000000000000000000000001
 1000000000001111331111220220220221
  10000000001   1001   10000000001
   110000011    1001    122000221
     10001      1001     1120211
      131       1001       101
      101       1001       101
      101       1001       101
      101111111110011111111101
      100000000000000000000001
      101111111110011111111101
      101       1001       101
      101       1001       101
     10001      1001      10001
   110000011    1001    110000011
  10000000001   1001   10000000001
 1000000000001111001111000000000001
 1000000000000001001000000000000001
 1000000000001111001111000000000001
  10000000001   1001   10000000001
   110000011    1001    110000011
     11111      1001      11111
                1331
                1331
          1111111001111111
          1000000000000001
          1000000000000001
          1000000000000001
          1000000000000001
          1000000000000001
          1000000000000001
          1000000000000001
          1000000000000001
          1000000000000001
          1111111111111111