R 1080 720
NO ./textures/sky_1.xpm
SO ./textures/metal.xpm
WE ./textures/wood.xpm
EA ./textures/stone.xpm

S ./path_to_the_sprite_texture
C 100,100,255
F 50,50,50

111111111111111
133333333333331
133333333333331
133333333333331
133333333333331
133333333333331
133333333333331
1333333N3333331
133333333333331
133333333333331
133333333333331
133333333333331
133333333333331
133333333333331
111111111111111
