R 1080 720
NO ./textures/mur_1.xpm
SO ./textures/mur_2.xpm
WE ./textures/mur_1.xpm
EA ./textures/mur_2.xpm

S ./path_to_the_sprite_texture
C 100,100,255
F 50,50,50





























     11111                11111
   110000011            110030011
  10000000001          10000000001
 1000000000001111111111000000000001
 100000N000000000000000000002000001
 1000000000001111331111030000000001
  10000000001   1001   10000000001
   110000011    1001    100000001
     11311      1001     1100011
      101       1001       101
      101       1001       101
      101       1001       101
      101111111110011111111101
      100000000000000000000001
      101111111110011111111101
      101       1001       101
      101       1001       101
     10001      1001      10001
   110000011    1001    110000011
  10000000001   1001   10000000001
 1000000000001111001111000000000001
 1000000000000000000000000000000001
 1000000000001111001111000000000001
  10000000001   1001   10000000001
   110000011    1001    110000011
     11111      1001      11111
                1001
                1001
          1111111001111111
          1000000000000001
          1000000000000001
          1000000000000001
          1000000000000001
          1000000000000001
          1000000000000001
          1000000000000001
          1000000000000001
          1000000000000001
          1111111111111111